11111111111111111111111111
1010000001000100000C001001
100P010000000C0010001C10E1
11111111111111111111111111