111111111111111111
10000000000001C0P1
1C1111111110011101
100001000000000001
10000100000C000001
1000C1000000000001
111111111111110001
100000000000000001
100000C000000C0001
100000000000000001
10000000E000000001
111111111111111111