1111111111111111111111111
111P00C0000C0000000000001
1C1000000001111CC11111101
10100111111111111E1111C01
10C000000C0000001C000C001
1111111111111111111111111