1111111111111111
1100000000000011
1111011111110011
111100PEC1111111
1111111111111111