1111111111111111
1000000P00000001
1000000000000E01
100000C0000C0001
1111111111111111