1111111111111111111
1P00010C01E000000C1
10000101010000C0001
10C0010101111111011
10000C0100C00000011
1111111111111111111